1111111111111111111111111111
1111111111111111111111111111
1111111111111111111111111111
1111111000000000011111111111
1111111000000000011111111111
1111111000000000011111111111
1111111000000000011111111111
1111111000000000011111111111
1111111000000000011111111111
111G111000000000011111111111
1111111000000000011111111111
1111111000000000011111111111
1111111000000000011111111111
1111111000000000011111111111
1111111000000000011111111111
1111111000000000011111111111
1111111111111111111111111111
1111111111111111111111111111
1111111111111111111111111111
